Please transcribe and expand all details from this herbarium label. 
Include full expansion of any abbreviations present. 
For all entries do not shorten units of measurement and always print out full units(mi to miles, m to meters, ft to feet). 
Do not Include any Full stops in Entries. 
For all day representations use (day-month-year) If the output includes any words or phrases not in English, translate them to English. 
For Titles do not use All Capitals, only capitalize names and locations and do not abbreviate any names or locations. 
fields are using DarwinCore formatting. 
If there is no information present for a field insert N/A. If unsure at all, state “unsure and check”. 
I require information on the following categories and to output in the following order(Make sure the fields are exactly as typed). 
Finally, can you verify the accepted scientific name from a source through a web search using an authority like gbif or tropicos? The name on the label maybe a synonym and older name. Please cite your sources.

title: (A name given to the resource), 
collectedBy: (The First Collector)
secondaryCollectors: (These are collectors listed after the first)
recordNumber:( An identifier given to the occurrence at the time it was recorded - this is the collection number by the person who collected the specimen), 
verbatimEventDate: (The original verbatim text of the date and time information for the original occurrence), 
eventDate: (The date-time or interval during which an event occurred or the original occurrence , in an ISO 8601 date format, Separate day, month, year with -, this might also be a range of dates), 
acceptedScientificName: (The full scientific name, according to the latest taxonomic treatment according to the World Flora Online - An Online Flora of All Known Plants (acceptance), of the organism referred to in the occurrence record). If there are multiple scientific names select the one with the latest determination date.
phylum: (Division): The phylum or division in which the taxon is classified, 
family: (The family in which the taxon is classified), 
genus: (The genus in which the taxon is classified), 
specificEpithet: (The specific epithet of the scientific name; in binomial nomenclature, the second part of the name), 
infraspecificEpithet: (The infraspecific epithet of the scientific name; in trinomial nomenclature, the third part of the name), 
scientificNameAuthorship: (The authorship information for the scientific name formatted according to the conventions of the applicable nomenclatural code), 
identifiedBy: (this is the person who identified the specimen, sometimes represented by det. Or determined by. There might be multiple labels reflecting this. If unsure, insert that. Or if nothing - N/A.
dateIdentified: (The date on which the subject was identified as representing the Taxon. This is not eventDate so make sure to differentiate), 
otherScientificName: (Alternative scientific names that have been applied to the specimen), associatedTaxa: (This is a taxonomic name that maybe directly associated with the acceptedScientificName. i.e., it is growing directly with the acceptedScientificName. This is not a scientific name that is associated with the general forest or vegetation that describes the habitat), 
country: (The name of the country or major administrative unit in which the event occurred), 
countryCode: (The standard code for the country in which the event occurred), 
firstPoliticalUnit: (The name of the first-order administrative division in which the event occurred (e.g., state or province)), 
secondPoliticalUnit:  The name of the second-order administrative division in which the event occurred (e.g., county)), 
city: (The city or locality in which the event occurred), 
verbatimLocality: (The original textual description of the place where the occurrence was recorded), 
locality: (The specific description of the place. Less specific than verbatimLocality), 
habitat: (A category or description of the habitat in which the event occurred), 
substrate: (The underlying material or surface on which an organism lives or grows), verbatimElevation: (The original verbatim text of the elevation (altitude, depth) of the occurrence), 
maximumElevationInMeters: (The upper limit of elevation (in meters) for the occurrence), minimumElevationInMeters: (The lower limit of elevation (in meters) for the occurrence. If there is only one measurement of elevation it is in the minimumElevationInMeters), verbatimCoordinates: (The original verbatim text of the coordinates), 
decimalLatitude: (The latitude of the location from which the occurrence was recorded, expressed in decimal degrees), 
decimalLongitude: (The longitude of the location from which the occurrence was recorded, expressed in decimal degrees), 
occurrenceRemarks: (Comments or notes about the occurrence), 
collectionCode: (The identifier for the collection or dataset from which the record was derived.), catalogNumber: (An identifier for the record within the dataset - this is not to be confused with the recordNumber which is often on a sheet not on a collection label), 
language: (The language of the resource), 
languageRemarks: (Comments or notes about the language of the resource), 
originalMethod ((Handwritten, Typed, Mix of Handwritten and Typed): The method by which the original data was recorded), 
typeStatus: If the specimen has “type” written or typed on the label and can take the form holotype, isotype etc state as such, otherwise so “no type status”
sex: This might come in the form of a symbol on the label, male, female 
reproductiveCondition: the label might include information about reproductive features such as perianth, sporophyte (these might be abbreviated). Spell out perianth, sporophyte or any remarks.
generalNotes: (Additional comments or notes not covered but are on the label)
generalInformationAboutThePlantSpecimenItself: (or example, does it look like there are multiple plant specimens mounted on a sheet? Is there soil present? Does the sample look small, moderate or large? Otherwise N/A)
expeditionFundedBy: Some collection events might be sponsored or funded by a foundation or government agency. Record this information.